5 8 0 13
############# ##########
#     #                #
#     ####          ####
#                      #
#         ###          #
######## ###############