5 1 0 2
## #####################
#  #        #          #
#       ##  #        ###
###             #      #
#      #        ##     #
# ######################