5 21 0 1
# ######################
#        #             #
##### ###    #      ####
#   #        #         #
#       #   ##         #
##################### ##